11111111111111111111111111111111
1...1......1............1....1.1
1.1....111.1..111..111..1..1.1.1
1.11..111..11.1.....1...11.1...1
1.1...1.1.....1...1........11..1
1.1..11.1111111.1.111111....1..1
1.1.....1.......1......111.....1
1.1111111.111111111..1.1.11111.1
1.......1...1........1.1.....1.1
1.......111.1..1111111.1.......1
1...........1........1...1.....1
1...............1..1.11111.....1
1..............111.1...........1
1..................11..........1
1.......1..............1.......1
1.......1........M.....1.......1
1.......1..............1.......1
1.......1..............1.......1
1.......11111......11111.......1
1..............................1
1..............................1
1..P...........................1
1..............................1
11111111111111111111111111111111

